11
0 0 0 0 0 0 1 0 0 1
0 0 0 0 0 0 0 1 1 1
0 0 0 1 0 1 1 1 1 0
0 0 X 0 0 0 0 0 0 0
0 0 0 0 1 1 0 1 1 1
0 0 0 0 0 1 0 0 0 1
0 1 0 1 0 1 1 0 1 1
0 1 0 0 0 1 0 0 1 1
0 0 0 0 1 0 0 0 0 0
F 0 0 0 0 0 0 0 0 0
12
0 0 0 0 1 0 0 0 0 1
0 0 0 1 0 0 1 1 0 0
1 0 0 1 1 1 0 0 1 0
0 0 X 0 0 0 0 0 0 0
1 0 1 0 0 1 0 1 1 0
0 0 1 0 0 0 0 0 0 1
0 1 0 1 0 1 1 0 1 1
1 0 0 0 0 1 1 0 0 0
0 0 0 0 0 0 0 0 0 1
F 0 0 0 1 0 0 0 0 0
13
0 0 1 0 0 1 0 1 0 0
0 0 0 1 1 0 0 0 1 0
1 1 0 0 0 1 1 0 0 0
0 0 X 0 0 1 0 0 0 0
0 0 0 1 1 0 1 0 0 0
1 0 0 0 0 1 0 0 0 1
1 0 0 1 0 1 0 0 1 0
1 0 0 0 0 1 0 0 0 0
0 0 0 1 0 1 0 0 1 0
F 0 0 0 1 0 0 0 1 0
14
1 0 0 0 0 0 1 1 0 0
0 0 0 1 0 0 1 0 0 1
0 1 0 0 1 0 0 1 0 0
0 0 X 0 0 0 1 1 0 0
0 1 1 0 0 0 0 0 1 1
1 0 0 0 0 1 1 0 0 0
1 0 0 0 1 0 0 0 0 1
1 0 0 0 1 1 0 0 0 1
0 0 0 1 0 0 1 0 0 1
F 0 0 0 0 0 0 0 0 0
15
1 0 0 0 1 0 0 1 1 0
0 0 1 0 0 0 1 0 0 1
1 0 0 0 0 1 0 0 1 0
1 0 X 0 0 0 0 0 0 0
1 0 0 0 0 1 1 0 0 0
1 0 0 0 0 0 0 1 1 0
0 1 0 0 0 1 0 0 1 0
0 0 0 0 0 0 1 0 0 1
1 1 0 0 0 1 0 0 0 0
F 0 0 0 1 0 0 1 1 0
16
1 0 0 1 1 0 1 0 0 1
0 0 0 1 0 1 0 0 0 1
1 0 0 0 0 0 0 1 0 1
0 0 X 0 0 0 0 0 0 0
1 1 1 0 0 1 0 0 0 1
1 0 0 0 0 0 0 0 0 0
1 0 0 0 1 0 1 1 0 1
0 0 0 0 1 1 0 1 0 0
0 0 0 0 1 0 1 1 0 0
F 0 0 0 1 0 0 1 1 0
17
1 0 0 1 0 0 0 1 0 0
0 1 0 0 0 1 0 0 1 0
1 1 1 0 0 0 0 0 1 0
1 0 X 0 1 1 0 0 0 0
0 1 1 0 0 0 0 0 1 1
0 1 1 0 0 1 0 0 1 0
0 1 0 1 0 0 1 0 1 0
0 0 0 1 0 0 0 0 0 0
0 0 0 0 0 0 0 1 1 0
F 0 0 0 0 0 0 0 0 0
18
0 0 1 0 0 0 0 0 1 0
1 0 0 0 1 1 0 0 1 0
1 1 1 0 0 0 0 0 0 0
0 0 X 0 0 0 0 1 1 0
0 1 0 0 1 1 0 0 1 1
0 0 0 0 0 0 0 0 0 0
0 1 0 0 0 1 0 0 1 0
0 0 0 0 0 0 0 0 1 1
0 0 1 0 0 1 0 0 0 1
F 0 0 0 0 0 1 1 1 0
19
1 0 1 0 1 0 0 1 0 1
0 1 0 0 1 0 1 0 0 1
0 1 0 1 0 0 1 0 0 1
1 0 X 0 0 0 0 0 0 0
1 0 1 0 0 0 0 0 0 0
1 0 1 0 0 0 0 0 0 0
1 1 1 1 0 0 0 0 0 1
1 0 0 1 0 0 0 0 0 0 
1 0 1 0 0 0 0 0 0 0
F 0 0 0 0 0 0 0 1 1
20
1 1 0 0 0 1 0 0 0 0
0 0 1 0 0 0 1 0 0 0
0 0 0 1 0 0 0 0 1 0
0 1 X 0 1 0 0 1 0 0
0 0 0 0 0 0 1 0 0 0
0 1 0 1 0 0 0 1 0 1
0 0 1 0 0 1 0 0 1 0
0 0 0 1 0 0 1 0 0 1
0 0 0 0 1 0 0 1 0 1
F 0 0 0 0 1 1 1 0 0

//semaforo 3 bandera 2
